********************
* R          *     *
*   *     R    *   *
*     *            *
*          *       *
*   R          H   *
*         *        *
*  *          *    *
*      *     *     *
********************